0 0 0 0 0 0 0 0 0 0 0 0 0 0 0 0 0 0 0 0 0 0 0 940 941 941 941 941 941 941 941 941 941 941 941 941 941 941 941 941 941 941 941 941 941 941 941 941 941 941 941 941 941 941 941 941 941 941 941 941 942 0 0 0 0 0 0 0 0 0 0 0 0 0 0 0 0 0 0 0 0 0 0 0 0 0 0 0 0 0 0 0 0 0 0 0 0 0 0 0 
0 0 0 0 0 0 0 0 0 0 0 0 0 0 0 0 0 0 0 0 0 0 0 960 253 254 254 254 254 254 254 254 254 254 254 254 254 254 254 254 254 254 254 254 254 254 254 254 254 254 254 254 254 254 254 254 254 254 254 255 960 0 0 0 0 0 0 0 0 0 0 0 0 0 0 0 0 0 0 0 0 0 0 0 0 0 0 0 0 0 0 0 0 0 0 0 0 0 0 0 
0 0 0 0 0 0 0 0 0 0 0 0 0 0 0 0 0 0 0 0 0 0 0 960 274 275 296 296 296 296 296 296 296 296 296 296 296 296 296 296 296 296 296 296 296 296 296 296 296 296 296 296 296 296 296 296 296 296 275 276 960 0 0 0 0 0 0 0 0 0 0 0 0 0 0 0 0 0 0 0 0 0 0 0 0 0 0 0 0 0 0 0 0 0 0 0 0 0 0 0 
0 0 0 0 0 0 0 0 0 0 0 0 0 0 0 0 0 0 0 0 0 0 0 960 274 276 127 128 128 128 128 128 128 128 128 128 128 128 128 128 128 128 128 128 128 128 128 128 128 128 128 128 128 128 128 128 128 129 274 276 960 0 0 0 0 0 0 0 0 0 0 0 0 0 0 0 0 0 0 0 0 0 0 0 0 0 0 0 0 0 0 0 0 0 0 0 0 0 0 0 
0 0 0 0 0 0 0 0 0 0 0 0 0 0 0 0 0 0 0 0 0 0 0 960 274 276 148 149 149 149 149 149 149 149 149 149 149 149 149 149 149 149 149 149 149 149 149 149 149 149 149 149 149 149 149 149 149 150 274 276 960 0 0 0 0 0 0 0 0 0 0 0 0 0 0 0 0 0 0 0 0 0 0 0 0 0 0 0 0 0 0 0 0 0 0 0 0 0 0 0 
0 0 0 0 0 0 0 0 0 0 0 0 0 0 0 0 0 0 0 0 0 0 0 960 274 276 148 149 149 149 149 149 149 149 149 149 149 149 149 149 149 149 149 149 149 149 149 149 149 149 149 149 149 149 149 149 149 150 274 276 960 0 0 0 0 0 0 0 0 0 0 0 0 0 0 0 0 0 0 0 0 0 0 0 0 0 0 0 0 0 0 0 0 0 0 0 0 0 0 0 
0 0 0 0 0 0 0 0 0 0 0 0 0 0 0 0 0 0 0 0 0 0 0 960 274 276 148 149 149 149 149 149 149 149 149 149 149 149 149 149 149 149 149 149 149 149 149 149 149 149 149 149 149 149 149 149 149 150 274 276 960 0 0 0 0 0 0 0 0 0 0 0 0 0 0 0 0 0 0 0 0 0 0 0 0 0 0 0 0 0 0 0 0 0 0 0 0 0 0 0 
0 0 0 0 0 0 0 0 0 0 0 0 0 0 0 0 0 0 0 0 0 0 0 960 274 276 148 149 149 149 149 149 149 149 149 149 149 149 149 149 149 149 149 149 149 149 149 149 149 149 149 149 149 149 149 149 149 150 274 276 960 0 0 0 0 0 0 0 0 0 0 0 0 0 0 0 0 0 0 0 0 0 0 0 0 0 0 0 0 0 0 0 0 0 0 0 0 0 0 0 
0 0 0 0 0 0 0 0 0 0 0 0 0 0 0 0 0 0 0 0 0 0 0 960 274 276 148 149 149 149 149 149 149 149 149 149 149 149 149 149 149 149 149 149 149 149 149 149 149 149 149 149 149 149 149 149 149 150 274 276 960 0 0 0 0 0 0 0 0 0 0 0 0 0 0 0 0 0 0 0 0 0 0 0 0 0 0 0 0 0 0 0 0 0 0 0 0 0 0 0 
0 0 0 0 0 0 0 0 0 0 0 0 0 0 0 0 0 0 0 0 0 0 0 960 274 276 148 149 149 149 149 149 149 149 149 149 149 149 149 149 149 149 149 149 149 149 149 149 149 149 149 149 149 149 149 149 149 150 274 276 960 0 0 0 0 0 0 0 0 0 0 0 0 0 0 0 0 0 0 0 0 0 0 0 0 0 0 0 0 0 0 0 0 0 0 0 0 0 0 0 
0 0 0 0 0 0 0 0 0 0 0 0 0 0 0 0 0 0 0 0 0 0 0 960 274 276 148 149 149 149 149 149 149 149 149 149 149 149 149 149 149 149 149 149 149 149 149 149 149 149 149 149 149 149 149 149 149 150 274 276 960 0 0 0 0 0 0 0 0 0 0 0 0 0 0 0 0 0 0 0 0 0 0 0 0 0 0 0 0 0 0 0 0 0 0 0 0 0 0 0 
0 0 0 0 0 0 0 0 0 0 0 0 0 0 0 0 0 0 0 0 0 0 0 960 274 276 148 149 149 149 149 149 149 149 149 149 149 149 149 149 149 149 149 149 149 149 149 149 149 149 149 149 149 149 149 149 149 150 274 276 960 0 0 0 0 0 0 0 0 0 0 0 0 0 0 0 0 0 0 0 0 0 0 0 0 0 0 0 0 0 0 0 0 0 0 0 0 0 0 0 
0 0 0 0 0 0 0 0 0 0 0 0 0 0 0 0 0 0 0 0 0 0 0 960 274 276 148 149 149 149 149 149 149 149 149 149 149 149 149 149 149 149 149 149 149 149 149 149 149 149 149 149 149 149 149 149 149 150 274 276 960 0 0 0 0 0 0 0 0 0 0 0 0 0 0 0 0 0 0 0 0 0 0 0 0 0 0 0 0 0 0 0 0 0 0 0 0 0 0 0 
0 0 0 0 0 0 0 0 0 0 0 0 0 0 0 0 0 0 0 0 0 0 0 960 274 276 148 149 149 149 149 149 149 149 149 149 149 149 149 149 149 149 149 149 149 149 149 149 149 149 149 149 149 149 149 149 149 150 274 276 960 0 0 0 0 0 0 0 0 0 0 0 0 0 0 0 0 0 0 0 0 0 0 0 0 0 0 0 0 0 0 0 0 0 0 0 0 0 0 0 
0 0 0 0 0 0 0 0 0 0 0 0 0 0 0 0 0 0 0 0 0 0 0 960 274 276 148 149 149 149 149 149 149 149 149 149 149 149 149 149 149 149 149 149 149 149 149 149 149 149 149 149 149 149 149 149 149 150 274 276 960 0 0 0 0 0 0 0 0 0 0 0 0 0 0 0 0 0 0 0 0 0 0 0 0 0 0 0 0 0 0 0 0 0 0 0 0 0 0 0 
0 0 0 0 0 0 0 0 0 0 0 0 0 0 0 0 0 0 0 0 0 0 0 960 274 276 148 149 149 149 149 149 149 149 149 149 149 149 149 149 149 149 149 149 149 149 149 149 149 149 149 149 149 149 149 149 149 150 274 276 960 0 0 0 0 0 0 0 0 0 0 0 0 0 0 0 0 0 0 0 0 0 0 0 0 0 0 0 0 0 0 0 0 0 0 0 0 0 0 0 
0 0 0 0 0 0 0 0 0 0 0 0 0 0 0 0 0 0 0 0 0 0 0 960 274 276 148 149 149 149 149 149 149 149 149 149 149 149 149 149 149 149 149 149 149 149 149 149 149 149 149 149 149 149 149 149 149 150 274 276 960 0 0 0 0 0 0 0 0 0 0 0 0 0 0 0 0 0 0 0 0 0 0 0 0 0 0 0 0 0 0 0 0 0 0 0 0 0 0 0 
0 0 0 0 0 0 0 0 0 0 0 0 0 0 0 0 0 0 0 0 0 0 0 960 274 276 148 149 149 149 149 149 149 149 149 149 149 149 149 149 149 149 149 149 149 149 149 149 149 149 149 149 149 149 149 149 149 150 274 276 960 0 0 0 0 0 0 0 0 0 0 0 0 0 0 0 0 0 0 0 0 0 0 0 0 0 0 0 0 0 0 0 0 0 0 0 0 0 0 0 
0 0 0 0 0 0 0 0 0 0 0 0 0 0 0 0 0 0 0 0 0 0 0 960 274 276 148 149 149 149 149 149 149 149 149 149 149 149 149 149 149 149 149 149 149 149 149 149 149 149 149 149 149 149 149 149 149 150 274 276 960 0 0 0 0 0 0 0 0 0 0 0 0 0 0 0 0 0 0 0 0 0 0 0 0 0 0 0 0 0 0 0 0 0 0 0 0 0 0 0 
0 0 0 0 0 0 0 0 0 0 0 0 0 0 0 0 0 0 0 0 0 0 0 960 274 276 148 149 149 149 149 149 149 149 149 149 149 149 149 149 149 149 149 149 149 149 149 149 149 149 149 149 149 149 149 149 149 150 274 276 960 0 0 0 0 0 0 0 0 0 0 0 0 0 0 0 0 0 0 0 0 0 0 0 0 0 0 0 0 0 0 0 0 0 0 0 0 0 0 0 
0 0 0 0 0 0 0 0 0 0 0 0 0 0 0 0 0 0 0 0 0 0 0 960 274 276 148 149 149 149 149 149 149 149 149 149 149 149 149 149 149 149 149 149 149 149 149 149 149 149 149 149 149 149 149 149 149 150 274 276 960 0 0 0 0 0 940 941 941 941 941 941 941 941 941 941 941 941 941 941 941 941 941 942 0 0 0 0 0 0 0 0 0 0 0 0 0 0 0 0 
0 0 0 0 0 0 0 0 0 0 0 0 0 0 0 0 0 0 0 0 0 0 0 960 274 276 169 170 170 170 170 170 170 170 170 170 170 170 170 170 170 170 170 170 170 170 170 170 170 170 170 170 170 170 170 170 170 171 274 276 960 0 0 0 0 0 960 127 128 128 128 128 128 128 128 128 128 128 128 128 128 128 129 960 0 0 0 0 0 0 0 0 0 0 0 0 0 0 0 0 
0 0 0 0 0 0 0 0 0 0 0 0 0 0 0 0 0 0 0 0 0 0 0 960 274 275 254 254 254 254 254 254 254 254 254 254 254 254 254 254 254 254 254 254 254 254 254 254 254 254 254 254 254 254 254 254 254 254 275 276 960 0 0 0 0 0 960 148 149 149 149 940 942 149 149 149 149 940 942 149 149 149 150 960 0 0 0 0 0 0 0 0 0 0 0 0 0 0 0 0 
0 0 0 0 0 0 0 0 0 0 0 0 0 0 0 0 0 0 0 0 0 0 0 960 295 296 296 296 296 296 296 296 296 296 296 296 296 296 296 296 296 296 275 275 296 296 296 296 296 296 296 296 296 296 296 296 296 296 296 297 960 0 0 0 0 0 960 148 149 149 149 980 982 149 149 149 149 980 982 149 149 149 150 960 0 0 0 0 0 0 0 0 0 0 0 0 0 0 0 0 
0 0 0 0 0 0 0 0 0 0 0 0 0 0 0 0 0 0 0 0 0 0 0 980 941 941 941 941 941 941 941 941 941 941 941 941 941 941 941 941 941 942 274 276 940 941 941 941 941 941 941 941 941 941 941 941 941 941 941 941 982 0 0 0 0 0 960 148 149 149 149 149 149 149 149 149 149 149 149 149 149 149 150 960 0 0 0 0 0 0 0 0 0 0 0 0 0 0 0 0 
0 0 0 0 0 0 0 0 0 0 0 0 0 0 0 0 0 0 0 0 0 0 0 0 0 0 0 0 0 0 0 0 0 0 0 0 0 0 0 0 0 960 274 276 960 0 0 0 0 0 0 0 0 0 0 0 0 0 0 0 0 0 0 0 0 0 960 148 940 942 149 149 149 149 149 149 149 149 149 149 940 942 150 960 0 0 0 0 0 0 0 0 0 0 0 0 0 0 0 0 
0 0 0 0 0 0 0 0 0 0 0 0 0 0 0 0 0 0 0 0 0 0 0 0 0 0 0 0 0 0 0 0 940 941 941 941 941 941 941 941 941 982 274 276 980 941 941 941 941 941 941 941 941 942 0 0 0 0 0 0 0 0 0 0 0 0 960 148 980 982 149 149 149 149 149 149 149 149 149 149 980 982 150 960 0 0 0 0 0 0 0 0 0 0 0 0 0 0 0 0 
0 0 0 0 0 0 0 0 0 0 0 0 0 0 0 0 0 0 0 0 0 0 0 0 0 0 0 0 0 0 0 0 960 127 128 128 128 128 128 128 128 128 274 276 128 128 128 128 128 128 128 128 129 960 0 0 0 0 0 0 0 0 0 0 0 0 960 148 149 149 149 149 149 149 149 149 149 149 149 149 149 149 150 960 0 0 0 0 0 0 0 0 0 0 0 0 0 0 0 0 
0 0 940 941 941 941 941 941 941 941 941 941 941 941 941 941 941 941 941 941 942 0 0 0 0 0 0 0 0 0 0 0 960 148 940 942 149 149 149 149 149 149 274 276 149 149 149 149 149 149 940 942 150 960 0 0 0 0 0 0 0 0 0 0 0 0 960 148 149 149 149 940 942 149 149 149 149 940 942 149 149 149 150 960 0 940 941 941 941 941 941 941 941 941 941 942 0 0 0 0 
0 0 960 253 254 254 254 254 254 254 254 254 254 254 254 254 254 254 254 255 960 0 0 0 0 0 0 0 0 0 0 0 960 148 980 982 149 149 149 149 149 149 274 276 149 149 149 149 149 149 980 982 150 960 0 0 0 0 0 0 0 0 0 0 0 0 960 148 149 149 149 980 982 149 149 149 149 980 982 149 149 149 150 960 0 960 253 254 254 254 254 254 254 254 255 960 0 0 0 0 
0 0 960 274 127 128 128 128 128 128 128 128 128 128 128 128 128 128 129 276 960 0 0 0 0 0 0 0 0 0 0 0 960 148 149 149 149 940 942 149 149 149 274 276 149 149 149 940 942 149 149 149 150 960 0 0 0 0 0 0 0 0 0 0 0 0 960 148 149 149 149 149 149 149 149 149 149 149 149 149 149 149 150 960 0 960 274 127 128 128 128 128 128 129 276 960 0 0 0 0 
0 0 960 274 148 149 149 149 149 149 149 149 149 149 149 149 149 149 150 276 960 0 0 0 0 0 0 0 0 0 0 0 960 148 149 149 149 980 982 149 149 149 274 276 149 149 149 980 982 149 149 149 150 960 0 0 0 0 0 0 0 0 0 0 0 0 960 148 940 942 149 149 149 253 254 254 255 149 149 149 940 942 150 960 0 960 274 148 149 149 149 149 149 150 276 960 0 0 0 0 
0 0 960 274 148 149 149 149 149 149 149 149 149 149 149 149 149 149 150 276 960 0 940 941 941 941 941 941 941 941 941 941 982 148 149 149 149 149 149 149 149 149 274 276 149 149 149 149 149 149 149 149 150 980 941 941 941 941 941 941 941 941 941 941 942 0 960 148 980 982 149 149 253 275 275 275 275 255 149 149 980 982 150 960 0 960 274 148 149 149 149 149 149 150 276 960 0 0 0 0 
0 0 960 274 148 149 149 149 149 940 941 941 941 942 149 149 149 149 150 276 980 941 982 127 128 128 128 128 128 128 128 128 128 149 149 149 149 149 149 149 149 149 274 276 149 149 149 149 149 149 149 149 149 128 128 128 128 128 128 128 128 128 128 129 980 941 982 148 149 149 149 253 275 275 275 275 275 275 255 149 149 149 150 980 941 982 274 148 149 149 149 149 149 150 276 960 0 0 0 0 
0 0 960 274 148 149 149 149 149 960 278 279 280 960 149 149 149 149 150 275 279 279 279 279 279 279 279 279 279 279 279 279 279 279 279 279 279 279 279 279 279 279 279 279 279 279 279 279 279 279 279 279 279 279 279 279 279 279 279 279 279 279 279 279 279 279 279 279 279 279 279 275 275 275 275 275 275 275 275 279 279 279 279 279 279 279 274 148 149 149 149 149 149 150 276 960 0 0 0 0 
0 0 960 274 148 149 149 149 149 980 941 941 941 982 149 149 149 149 150 276 940 941 942 169 170 170 170 170 170 170 170 170 170 149 149 149 149 149 149 149 149 149 149 149 149 149 149 149 149 149 149 149 149 170 170 170 170 170 170 170 170 170 170 171 940 941 942 148 149 149 149 295 275 275 275 275 275 275 297 149 149 149 150 940 941 942 274 148 149 149 149 149 149 150 276 960 0 0 0 0 
0 0 960 274 148 149 149 149 149 149 149 149 149 149 149 149 149 149 150 276 960 0 980 941 941 941 941 941 941 941 941 941 942 148 149 149 149 149 149 149 149 149 149 149 149 149 149 149 149 149 149 149 150 940 941 941 941 941 941 941 941 941 941 941 982 0 960 148 149 149 149 149 295 275 275 275 275 297 149 149 149 149 150 960 0 960 274 148 149 149 149 149 149 150 276 960 0 0 0 0 
0 0 960 274 148 149 149 149 149 149 149 149 149 149 149 149 149 149 150 276 960 0 0 0 0 0 0 0 0 0 0 0 960 148 940 942 149 149 940 942 149 149 940 942 149 149 940 942 149 149 940 942 150 960 0 0 0 0 0 0 0 0 0 0 0 0 960 148 940 942 149 149 149 295 275 275 297 149 149 149 940 942 150 960 0 960 274 148 149 149 149 149 149 150 276 960 0 0 0 0 
0 0 960 274 169 170 170 170 170 170 170 170 170 170 170 170 170 170 171 276 960 0 0 0 0 0 0 0 0 0 0 0 960 148 980 982 149 149 980 982 149 149 980 982 149 149 980 982 149 149 980 982 150 960 0 0 0 0 0 0 0 0 0 0 0 0 960 148 980 982 149 149 149 149 274 276 149 149 149 149 980 982 150 960 0 960 274 169 170 170 170 170 170 171 276 960 0 0 0 0 
0 0 960 295 296 296 296 296 296 296 296 296 296 296 296 296 296 296 296 297 960 0 0 0 0 0 0 0 0 0 0 0 960 148 149 149 149 149 149 149 149 149 149 149 149 149 149 149 149 149 149 149 150 960 0 0 0 0 0 0 0 0 0 0 0 0 960 148 149 149 149 149 149 149 274 276 149 149 149 149 149 149 150 960 0 960 295 296 296 296 296 296 296 296 297 960 0 0 0 0 
0 0 980 941 941 941 941 941 941 941 941 941 941 941 941 941 941 941 941 941 982 0 0 0 0 0 0 0 0 0 0 0 960 148 149 149 149 149 149 149 149 149 149 149 149 149 149 149 149 149 149 149 150 960 0 0 0 0 0 0 0 0 0 0 0 0 960 148 149 149 149 940 942 149 274 276 149 940 942 149 149 149 150 960 0 980 941 941 941 941 941 941 941 941 941 982 0 0 0 0 
0 0 0 0 0 0 0 0 0 0 0 0 0 0 0 0 0 0 0 0 0 0 0 0 0 0 0 0 0 0 0 0 960 169 170 170 170 170 170 170 170 170 170 170 170 170 170 170 170 170 170 170 171 960 0 0 0 0 0 0 0 0 0 0 0 0 960 148 149 149 149 980 982 149 274 276 149 980 982 149 149 149 150 960 0 0 0 0 0 0 0 0 0 0 0 0 0 0 0 0 
0 0 0 0 0 0 0 0 0 0 0 0 0 0 0 0 0 0 0 0 0 0 0 0 0 0 0 0 0 0 0 0 980 941 941 941 941 941 941 941 941 941 941 941 941 941 941 941 941 941 941 941 941 982 0 0 0 0 0 0 0 0 0 0 0 0 960 148 149 149 149 149 149 149 274 276 149 149 149 149 149 149 150 960 0 0 0 0 0 0 0 0 0 0 0 0 0 0 0 0 
0 0 0 0 0 0 0 0 0 0 0 0 0 0 0 0 0 0 0 0 0 0 0 0 0 0 0 0 0 0 0 0 0 0 0 0 0 0 0 0 0 0 0 0 0 0 0 0 0 0 0 0 0 0 0 0 0 0 0 0 0 0 0 0 0 0 960 148 940 942 149 149 149 149 274 276 149 149 149 149 940 942 150 960 0 0 0 0 0 0 0 0 0 0 0 0 0 0 0 0 
0 0 0 0 0 0 0 0 0 0 0 0 0 0 0 1187 1188 941 941 1189 0 0 0 0 0 0 0 0 0 0 0 0 0 0 0 0 0 0 0 0 0 0 0 0 0 0 0 0 0 0 0 0 0 0 0 0 0 0 0 0 0 0 0 0 0 0 960 148 980 982 149 149 149 149 274 276 149 149 149 149 980 982 150 960 0 0 0 0 0 0 0 0 0 0 0 0 0 0 0 0 
0 0 0 0 0 0 0 0 0 0 0 940 1188 941 1188 1229 135 135 136 1207 0 0 0 0 0 0 0 0 0 0 0 0 0 0 0 0 0 0 0 0 0 0 0 0 0 0 0 0 0 0 0 0 0 0 0 0 0 0 0 0 0 0 0 0 0 0 960 148 149 149 149 149 149 149 274 276 149 149 149 149 149 149 150 960 0 0 0 0 0 0 0 0 0 0 0 0 0 0 0 0 
0 0 0 0 0 0 0 0 0 0 0 1207 134 135 135 156 156 156 156 1227 940 941 941 941 941 941 941 941 941 941 941 941 941 941 942 0 0 940 941 941 941 941 941 941 941 942 0 0 0 0 0 0 0 0 0 0 0 0 0 0 0 0 0 0 0 0 960 148 149 149 149 940 942 149 274 276 149 940 942 149 149 149 150 960 0 0 0 0 0 0 0 0 0 0 0 0 0 0 0 0 
0 0 0 0 0 0 0 0 0 0 0 960 155 156 156 156 156 156 156 156 960 127 128 128 128 128 128 128 128 128 128 128 128 129 960 0 0 960 127 128 128 128 128 128 129 960 0 0 0 0 0 0 0 0 0 0 0 0 0 0 0 0 0 0 0 0 960 148 149 149 149 980 982 149 274 276 149 980 982 149 149 149 150 960 0 0 0 0 0 0 0 0 0 0 0 0 0 0 0 0 
0 0 0 0 0 0 0 0 0 0 0 1207 156 156 156 156 156 156 156 156 1200 135 136 139 149 149 149 149 149 149 149 149 149 150 980 941 941 982 148 149 149 149 149 149 150 960 0 0 0 0 0 0 0 0 0 0 0 0 0 0 0 0 0 0 0 0 960 148 149 149 149 149 149 149 274 276 149 149 149 149 149 149 150 960 0 0 0 0 0 0 0 0 0 0 0 0 0 0 0 0 
0 0 0 0 0 0 0 0 0 0 0 960 176 177 177 156 156 156 156 156 1200 156 177 161 149 149 149 149 149 149 149 149 149 149 153 153 153 153 149 149 149 149 149 149 150 960 0 0 0 0 0 0 0 0 0 0 0 0 0 0 0 0 0 0 0 0 960 169 170 170 170 170 170 170 274 276 170 170 170 170 170 170 171 960 0 0 0 0 0 0 0 0 0 0 0 0 0 0 0 0 
0 0 0 0 0 0 0 0 0 0 0 1227 941 1188 1189 156 177 177 156 178 960 179 149 139 149 149 149 149 149 149 149 149 149 150 940 941 941 942 148 149 149 149 149 149 150 960 0 0 0 0 0 0 0 0 0 0 0 0 0 0 0 0 0 0 0 0 980 941 941 941 941 941 941 942 274 276 940 941 941 941 941 941 941 982 0 0 0 0 0 0 0 0 0 0 0 0 0 0 0 0 
0 0 0 0 0 0 0 0 0 0 0 0 0 0 1207 139 1187 942 179 941 960 148 149 149 149 149 149 149 149 149 149 149 149 150 960 0 0 960 169 170 170 170 170 170 171 960 0 0 0 0 0 0 0 0 0 0 0 0 0 0 0 0 0 0 0 0 0 0 0 0 0 0 0 960 274 276 960 0 0 0 0 0 0 0 0 0 0 0 0 0 0 0 0 0 0 0 0 0 0 0 
0 0 0 0 0 0 0 0 0 0 0 0 0 0 980 1188 982 1227 1188 1188 960 148 149 149 149 139 134 161 149 149 149 149 149 150 960 0 0 980 941 941 941 941 941 941 941 982 0 0 0 0 0 0 0 0 0 0 0 0 0 0 0 0 0 0 0 0 0 0 0 0 0 0 0 960 274 276 960 0 0 0 0 0 0 0 0 0 0 0 0 0 0 0 0 0 0 0 0 0 0 0 
0 0 0 0 0 0 0 0 0 0 0 0 0 0 0 0 0 0 0 0 960 148 149 139 149 149 179 149 149 149 149 149 149 150 960 0 0 0 0 0 0 0 0 0 0 0 0 0 0 0 0 0 0 0 0 0 0 0 0 0 0 0 0 0 0 0 0 0 0 0 0 0 0 960 274 276 960 0 0 0 0 0 0 0 0 0 0 0 0 0 0 0 0 0 0 0 0 0 0 0 
0 0 0 0 0 0 0 0 0 0 0 0 0 0 0 0 0 0 0 0 960 148 149 149 149 139 149 149 149 149 149 149 149 150 960 0 0 0 0 0 0 0 0 0 0 0 0 0 0 0 0 0 0 0 0 0 0 0 0 0 0 0 0 0 0 0 0 0 0 0 0 0 0 960 274 276 960 0 0 0 0 0 0 0 0 0 0 0 0 0 0 0 0 0 0 0 0 0 0 0 
0 0 0 0 0 0 0 0 0 0 0 0 0 0 0 0 0 0 0 0 960 148 149 149 149 149 149 149 149 149 139 149 149 150 960 0 0 0 0 0 0 0 0 0 0 0 0 0 0 0 0 0 0 0 0 0 0 0 0 0 0 0 0 0 0 0 0 940 941 941 941 941 941 982 274 276 980 941 941 941 941 941 942 0 0 0 0 0 0 0 0 0 0 0 0 0 0 0 0 0 
0 0 0 0 0 0 0 0 0 0 0 0 0 0 0 0 0 0 0 0 960 148 149 149 149 139 149 149 149 139 149 149 149 150 960 0 0 0 0 0 0 0 0 0 0 0 0 0 0 0 0 0 0 0 0 0 0 0 0 0 0 0 0 0 0 0 0 960 149 149 149 149 149 149 274 276 149 149 149 149 149 149 960 0 0 0 0 0 0 0 0 0 0 0 0 0 0 0 0 0 
0 0 0 0 0 0 0 0 0 0 0 0 0 0 0 0 0 0 0 0 960 148 149 139 149 149 149 149 149 149 149 149 149 150 960 0 0 0 0 0 0 0 0 0 0 0 0 0 0 0 0 0 0 0 0 0 0 0 0 0 0 0 0 0 0 0 0 960 149 149 149 149 149 149 274 276 149 149 149 149 149 149 960 0 0 0 0 0 0 0 0 0 0 0 0 0 0 0 0 0 
0 0 0 0 0 0 0 0 0 0 0 0 0 0 0 0 0 0 0 0 960 148 149 149 149 149 139 137 149 149 149 149 149 150 960 0 0 0 0 0 0 0 0 0 0 0 0 0 0 0 0 0 0 0 0 0 0 0 0 0 0 0 0 0 0 0 0 960 149 149 149 149 149 149 274 276 149 149 149 149 149 149 960 0 0 0 0 0 0 0 0 0 0 0 0 0 0 0 0 0 
0 0 0 0 0 0 0 0 0 0 0 0 0 0 0 0 0 0 0 0 960 148 149 149 149 134 135 157 149 149 149 149 149 150 960 0 0 0 0 0 0 0 0 0 0 0 0 0 0 0 0 0 0 0 0 0 0 0 0 0 0 0 0 0 0 0 0 960 149 149 149 149 149 149 274 276 149 149 149 149 149 149 960 0 0 0 0 0 0 0 0 0 0 0 0 0 0 0 0 0 
0 0 0 0 0 0 0 0 0 0 0 0 0 0 0 0 0 0 0 0 960 148 149 139 149 176 177 178 139 149 149 149 149 150 960 0 0 0 0 0 0 0 0 0 0 0 0 0 0 0 0 0 0 0 0 0 0 0 0 0 0 0 0 0 0 0 0 960 149 149 149 940 942 149 274 276 149 940 942 149 149 149 960 0 0 0 0 0 0 0 0 0 0 0 0 0 0 0 0 0 
0 0 0 0 0 0 0 0 0 0 0 0 0 0 0 0 0 0 0 0 960 148 149 149 149 149 149 149 149 149 149 149 149 150 960 0 0 0 0 0 0 0 0 0 0 0 0 0 0 0 0 0 0 0 0 0 0 0 0 0 0 0 0 0 0 0 0 960 149 149 149 980 982 149 274 276 149 980 982 149 149 149 960 0 0 0 0 0 0 0 0 0 0 0 0 0 0 0 0 0 
0 0 0 0 0 0 0 0 0 0 0 0 0 0 0 0 0 0 0 0 960 148 149 149 149 149 139 149 149 149 149 149 149 150 960 0 0 0 0 0 0 0 0 0 0 0 0 0 0 0 0 0 0 0 0 0 0 0 0 0 0 0 0 0 0 0 0 960 149 149 149 149 149 149 274 276 149 149 149 149 149 149 960 0 0 0 0 0 0 0 0 0 0 0 0 0 0 0 0 0 
0 0 0 0 0 0 0 0 0 0 0 0 0 0 0 0 0 0 0 0 960 148 149 149 137 149 149 149 149 149 149 149 149 150 960 0 0 0 0 0 0 0 0 0 0 0 0 0 0 0 0 0 0 0 0 0 0 0 0 0 0 0 0 0 0 0 0 960 149 149 149 149 149 149 274 276 149 149 149 149 149 149 960 0 0 0 0 0 0 0 0 0 0 0 0 0 0 0 0 0 
0 0 0 0 0 0 0 0 0 0 0 0 0 0 0 0 0 0 0 0 960 148 149 149 179 149 149 149 149 149 149 149 149 150 960 0 0 0 0 0 0 0 0 0 0 0 0 0 0 0 0 0 0 0 0 0 0 0 0 0 0 0 0 0 0 0 0 960 149 149 149 940 942 149 274 276 149 940 942 149 149 149 960 0 0 0 0 0 0 0 0 0 0 0 0 0 0 0 0 0 
0 0 0 0 0 0 0 0 0 0 0 0 0 0 0 0 0 0 0 0 960 148 149 139 149 149 149 149 149 139 149 149 149 150 960 0 0 0 0 0 0 0 0 0 0 0 0 0 0 0 0 0 0 0 0 0 0 0 0 0 0 0 0 0 0 0 0 960 149 149 149 980 982 149 274 276 149 980 982 149 149 149 960 0 0 0 0 0 0 0 0 0 0 0 0 0 0 0 0 0 
0 0 0 0 0 0 0 0 0 0 0 0 0 0 0 0 0 0 0 0 960 148 149 149 149 149 149 149 149 149 149 149 149 150 960 0 0 0 0 0 0 0 0 0 0 0 0 0 0 0 0 0 0 0 0 0 0 0 0 0 0 0 0 0 0 0 0 960 149 149 149 149 149 149 274 276 149 149 149 149 149 149 960 0 0 0 0 0 0 0 0 0 0 0 0 0 0 0 0 0 
0 0 0 0 0 0 0 0 0 0 0 0 0 0 0 0 0 0 0 0 960 148 149 149 149 139 149 149 149 149 149 149 149 150 960 0 0 0 0 0 0 0 0 0 0 0 0 0 0 0 0 0 0 0 0 0 0 0 0 0 0 0 0 0 0 0 0 960 149 149 149 149 149 149 274 276 149 149 149 149 149 149 960 0 0 0 0 0 0 0 0 0 0 0 0 0 0 0 0 0 
0 0 0 0 0 0 0 0 0 0 0 0 0 0 0 0 0 0 0 0 960 148 149 149 149 149 149 149 149 149 149 149 149 150 963 941 941 941 941 941 941 941 941 941 941 941 941 941 941 941 941 941 941 941 941 941 941 941 941 941 941 941 941 941 942 0 0 960 149 149 149 940 942 149 274 276 149 940 942 149 149 149 960 0 0 0 0 0 0 0 0 0 0 0 0 0 0 0 0 0 
0 0 0 0 0 0 0 0 0 0 0 0 0 0 0 0 0 0 0 0 960 148 149 149 149 149 149 149 139 149 149 149 149 150 960 127 128 128 128 128 128 128 128 128 128 128 128 128 128 128 128 128 128 128 128 128 128 128 128 128 128 128 128 129 960 0 0 960 149 149 149 980 982 149 274 276 149 980 982 149 149 149 960 0 0 0 0 0 0 0 0 0 0 0 0 0 0 0 0 0 
0 0 0 0 0 0 0 0 0 0 0 0 0 0 0 0 0 0 0 0 960 148 149 149 149 149 149 134 136 149 149 149 149 150 960 148 149 149 149 149 149 149 149 149 149 149 149 149 149 149 149 149 149 149 149 149 149 149 149 149 149 149 149 150 960 0 0 960 149 149 149 149 149 149 274 276 149 149 149 149 149 149 960 0 0 0 0 0 0 0 0 0 0 0 0 0 0 0 0 0 
0 0 0 0 0 0 0 0 0 0 0 0 0 0 0 0 0 0 0 0 960 148 149 149 149 149 149 155 156 135 136 139 255 150 960 253 254 254 254 254 254 254 254 254 254 254 254 254 254 254 254 254 254 254 254 254 254 254 254 254 254 254 254 255 980 941 941 982 149 253 254 254 254 254 254 254 254 254 254 254 255 149 960 0 0 0 0 0 0 0 0 0 0 0 0 0 0 0 0 0 
0 0 0 0 0 0 0 0 0 0 0 0 0 0 0 0 0 0 0 0 960 148 149 149 149 149 149 176 177 177 178 275 275 279 279 279 279 279 279 279 279 279 279 279 279 279 279 279 279 254 279 279 279 279 279 279 279 279 279 279 279 279 279 279 279 279 279 279 279 275 275 275 275 275 275 275 275 275 275 275 276 149 960 0 0 0 0 0 0 0 0 0 0 0 0 0 0 0 0 0 
0 0 0 0 0 0 0 0 0 0 0 0 0 0 0 0 0 0 0 0 960 148 149 149 149 149 149 149 149 295 296 139 297 150 960 295 296 296 296 296 296 296 296 296 296 296 296 296 275 277 275 296 296 296 296 296 296 296 296 296 296 296 296 297 940 941 941 942 149 295 296 296 296 296 296 296 296 296 296 296 297 149 960 0 0 0 0 0 0 0 0 0 0 0 0 0 0 0 0 0 
0 0 0 0 0 0 0 0 0 0 0 0 0 0 0 0 0 0 0 0 960 169 170 170 170 170 170 170 170 170 170 170 170 171 960 148 149 149 149 149 149 149 149 149 149 149 149 149 274 277 276 149 149 149 149 149 149 149 149 149 149 149 149 150 960 0 0 960 149 149 149 149 149 149 149 149 149 149 149 149 149 149 960 0 0 0 0 0 0 0 0 0 0 0 0 0 0 0 0 0 
0 0 0 0 0 0 0 0 0 0 0 0 0 0 0 0 0 0 0 0 980 941 941 941 941 941 941 941 941 941 941 941 941 941 965 169 170 170 170 170 170 170 170 149 149 149 149 149 274 277 276 149 149 149 149 149 170 170 170 170 170 170 170 171 960 0 0 960 149 149 149 149 149 149 149 149 149 149 149 149 149 149 960 0 0 0 0 0 0 0 0 0 0 0 0 0 0 0 0 0 
0 0 0 0 0 0 0 0 0 0 0 0 0 0 0 0 0 0 0 0 0 0 0 0 0 0 0 0 0 0 0 0 0 0 980 941 941 941 941 941 941 941 942 148 149 149 149 149 274 277 276 149 149 149 149 150 940 941 941 941 941 941 941 941 982 0 0 960 149 149 149 149 149 149 149 149 149 149 149 149 149 149 960 0 0 0 0 0 0 0 0 0 0 0 0 0 0 0 0 0 
0 0 0 0 0 0 0 0 0 0 0 0 0 0 0 0 0 0 0 0 0 0 0 0 0 0 0 0 0 0 0 0 0 0 0 0 0 0 0 0 0 0 960 148 149 149 149 149 274 277 276 149 149 149 149 150 960 0 0 0 0 0 0 0 0 0 0 960 149 149 149 149 149 149 149 149 149 149 149 149 149 149 960 0 0 0 0 0 0 0 0 0 0 0 0 0 0 0 0 0 
0 0 0 0 0 0 0 0 0 0 0 0 0 0 0 0 0 0 0 0 0 0 0 0 0 0 0 0 0 0 0 0 0 0 0 0 0 0 0 0 0 0 960 148 149 149 149 149 274 277 276 149 149 149 149 150 960 0 0 0 0 0 0 0 0 0 0 960 149 149 149 149 149 149 149 149 149 149 149 149 149 149 960 0 0 0 0 0 0 0 0 0 0 0 0 0 0 0 0 0 
0 0 0 0 0 0 0 0 0 0 0 0 0 0 0 0 0 0 0 0 0 0 0 0 0 0 0 0 0 0 0 0 0 0 0 0 0 0 0 0 0 0 960 169 170 170 170 170 274 277 276 170 170 170 170 171 960 0 0 0 0 0 0 0 0 0 0 980 941 941 941 941 941 941 941 941 941 941 941 941 941 941 982 0 0 0 0 0 0 0 0 0 0 0 0 0 0 0 0 0 
0 0 0 0 0 0 0 0 0 0 0 0 0 0 0 0 0 0 0 0 0 0 0 0 0 0 0 0 0 0 0 0 0 0 0 0 0 0 0 0 0 0 980 941 941 941 941 942 274 277 276 940 941 941 941 941 982 0 0 0 0 0 0 0 0 0 0 0 0 0 0 0 0 0 0 0 0 0 0 0 0 0 0 0 0 0 0 0 0 0 0 0 0 0 0 0 0 0 0 0 
0 0 0 0 0 0 0 0 0 0 0 0 0 0 0 0 0 0 0 0 0 0 0 0 0 0 0 0 0 0 0 0 0 0 0 0 0 940 941 941 941 941 941 941 941 941 941 982 295 258 297 980 941 941 941 941 941 941 941 941 941 942 0 0 0 0 0 0 0 0 0 0 0 0 0 0 0 0 0 0 0 0 0 0 0 0 0 0 0 0 0 0 0 0 0 0 0 0 0 0 
0 0 0 0 0 0 0 0 0 0 0 0 0 0 0 0 0 0 0 0 0 0 0 0 0 0 0 0 0 0 0 0 0 0 0 0 0 960 127 128 128 128 128 128 128 128 128 128 128 128 128 128 128 128 128 128 128 128 128 128 129 960 0 0 0 0 0 0 0 0 0 0 0 0 0 0 0 0 0 0 0 0 0 0 0 0 0 0 0 0 0 0 0 0 0 0 0 0 0 0 
0 0 0 0 0 0 0 0 0 0 0 0 0 0 0 0 0 0 0 0 0 0 0 0 0 0 0 0 0 0 0 0 0 0 0 0 0 960 148 149 149 149 149 149 149 149 149 149 149 149 149 149 149 149 149 149 149 149 149 149 150 960 0 0 0 0 0 0 0 0 0 0 0 0 0 0 0 0 0 0 0 0 0 0 0 0 0 0 0 0 0 0 0 0 0 0 0 0 0 0 
0 0 0 0 0 0 0 0 0 0 0 0 0 0 0 0 0 0 0 0 0 0 0 0 0 0 0 0 0 0 0 0 0 0 0 0 0 960 148 149 149 149 149 149 149 149 149 149 149 149 149 149 149 149 149 149 149 149 149 149 150 960 0 0 0 0 0 0 0 0 0 0 0 0 0 0 0 0 0 0 0 0 0 0 0 0 0 0 0 0 0 0 0 0 0 0 0 0 0 0 
0 0 0 0 0 0 0 0 0 0 0 0 0 0 0 0 0 0 0 0 0 0 0 0 0 0 0 0 0 0 0 0 0 0 0 0 0 960 148 149 149 149 149 149 149 149 149 149 149 149 149 149 149 149 149 149 149 149 149 149 150 960 0 0 0 0 0 0 0 0 0 0 0 0 0 0 0 0 0 0 0 0 0 0 0 0 0 0 0 0 0 0 0 0 0 0 0 0 0 0 
0 0 0 0 0 0 0 0 0 0 0 0 0 0 0 0 0 0 0 0 0 0 0 0 0 0 0 0 0 0 0 0 0 0 0 0 0 960 148 149 149 149 149 149 149 149 149 149 149 139 149 149 149 149 149 149 149 149 149 149 150 960 0 0 0 0 0 0 0 0 0 0 0 0 0 0 0 0 0 0 0 0 0 0 0 0 0 0 0 0 0 0 0 0 0 0 0 0 0 0 
0 0 0 0 0 0 0 0 0 0 0 0 0 0 0 0 0 0 0 0 0 0 0 0 0 0 0 0 0 0 0 0 0 0 0 0 0 960 148 149 149 149 149 149 149 149 149 149 139 139 149 149 149 149 149 149 149 149 149 149 150 960 0 0 0 0 0 0 0 0 0 0 0 0 0 0 0 0 0 0 0 0 0 0 0 0 0 0 0 0 0 0 0 0 0 0 0 0 0 0 
0 0 0 0 0 0 0 0 0 0 0 0 0 0 0 0 0 0 0 0 0 0 0 0 0 0 0 0 0 0 0 0 0 0 0 0 0 960 148 149 149 149 149 149 149 149 139 149 139 137 139 149 149 149 149 149 149 149 149 149 150 960 0 0 0 0 0 0 0 0 0 0 0 0 0 0 0 0 0 0 0 0 0 0 0 0 0 0 0 0 0 0 0 0 0 0 0 0 0 0 
0 0 0 0 0 0 0 0 0 0 0 0 0 0 0 0 0 0 0 0 0 0 0 0 0 0 0 0 0 0 0 0 0 0 0 0 0 960 148 149 149 149 149 149 149 149 149 134 135 156 136 149 149 149 149 149 149 149 149 149 150 960 0 0 0 0 0 0 0 0 0 0 0 0 0 0 0 0 0 0 0 0 0 0 0 0 0 0 0 0 0 0 0 0 0 0 0 0 0 0 
0 0 0 0 0 0 0 0 0 0 0 0 0 0 0 0 0 0 0 0 0 0 0 0 0 0 0 0 0 0 0 0 0 0 0 0 0 960 148 149 149 149 149 149 149 139 134 156 156 156 156 136 149 149 149 149 149 149 149 149 150 960 0 0 0 0 0 0 0 0 0 0 0 0 0 0 0 0 0 0 0 0 0 0 0 0 0 0 0 0 0 0 0 0 0 0 0 0 0 0 
0 0 0 0 0 0 0 0 0 0 0 0 0 0 0 0 0 0 0 0 0 0 0 0 0 0 0 0 0 0 0 0 0 0 0 0 0 960 148 149 149 149 149 139 139 149 155 156 156 156 156 157 139 149 149 149 149 149 149 149 150 960 0 0 0 0 0 0 0 0 0 0 0 0 0 0 0 0 0 0 0 0 0 0 0 0 0 0 0 0 0 0 0 0 0 0 0 0 0 0 
0 0 0 0 0 0 0 0 0 0 0 0 0 0 0 0 0 0 0 0 0 0 0 0 0 0 0 0 0 0 0 0 0 0 0 0 0 960 148 149 149 149 149 149 139 149 155 156 156 156 177 178 149 139 149 149 149 149 149 149 150 960 0 0 0 0 0 0 0 0 0 0 0 0 0 0 0 0 0 0 0 0 0 0 0 0 0 0 0 0 0 0 0 0 0 0 0 0 0 0 
0 0 0 0 0 0 0 0 0 0 0 0 0 0 0 0 0 0 0 0 0 0 0 0 0 0 0 0 0 0 0 0 0 0 0 0 0 960 148 149 149 149 149 149 149 139 176 177 177 178 149 139 139 149 149 149 149 149 149 149 150 960 0 0 0 0 0 0 0 0 0 0 0 0 0 0 0 0 0 0 0 0 0 0 0 0 0 0 0 0 0 0 0 0 0 0 0 0 0 0 
0 0 0 0 0 0 0 0 0 0 0 0 0 0 0 0 0 0 0 0 0 0 0 0 0 0 0 0 0 0 0 0 0 0 0 0 0 960 148 149 149 149 149 149 149 149 139 149 139 149 139 149 149 149 149 149 149 149 149 149 150 960 0 0 0 0 0 0 0 0 0 0 0 0 0 0 0 0 0 0 0 0 0 0 0 0 0 0 0 0 0 0 0 0 0 0 0 0 0 0 
0 0 0 0 0 0 0 0 0 0 0 0 0 0 0 0 0 0 0 0 0 0 0 0 0 0 0 0 0 0 0 0 0 0 0 0 0 960 148 149 149 149 149 149 149 149 149 149 149 149 149 149 149 149 149 149 149 149 149 149 150 960 0 0 0 0 0 0 0 0 0 0 0 0 0 0 0 0 0 0 0 0 0 0 0 0 0 0 0 0 0 0 0 0 0 0 0 0 0 0 
0 0 0 0 0 0 0 0 0 0 0 0 0 0 0 0 0 0 0 0 0 0 0 0 0 0 0 0 0 0 0 0 0 0 0 0 0 960 148 149 149 149 149 149 149 149 149 149 149 149 149 149 149 149 149 149 149 149 149 149 150 960 0 0 0 0 0 0 0 0 0 0 0 0 0 0 0 0 0 0 0 0 0 0 0 0 0 0 0 0 0 0 0 0 0 0 0 0 0 0 
0 0 0 0 0 0 0 0 0 0 0 0 0 0 0 0 0 0 0 0 0 0 0 0 0 0 0 0 0 0 0 0 0 0 0 0 0 960 148 149 149 149 149 149 149 149 149 149 149 149 149 149 149 149 149 149 149 149 149 149 150 960 0 0 0 0 0 0 0 0 0 0 0 0 0 0 0 0 0 0 0 0 0 0 0 0 0 0 0 0 0 0 0 0 0 0 0 0 0 0 
0 0 0 0 0 0 0 0 0 0 0 0 0 0 0 0 0 0 0 0 0 0 0 0 0 0 0 0 0 0 0 0 0 0 0 0 0 960 169 170 170 170 170 170 170 170 170 170 170 170 170 170 170 170 170 170 170 170 170 170 171 960 0 0 0 0 0 0 0 0 0 0 0 0 0 0 0 0 0 0 0 0 0 0 0 0 0 0 0 0 0 0 0 0 0 0 0 0 0 0 
0 0 0 0 0 0 0 0 0 0 0 0 0 0 0 0 0 0 0 0 0 0 0 0 0 0 0 0 0 0 0 0 0 0 0 0 0 980 941 941 941 941 941 941 941 941 941 941 941 941 941 941 941 941 941 941 941 941 941 941 941 982 0 0 0 0 0 0 0 0 0 0 0 0 0 0 0 0 0 0 0 0 0 0 0 0 0 0 0 0 0 0 0 0 0 0 0 0 0 0