940 941 941 941 941 941 941 941 941 941 941 152 153 154 941 941 941 941 941 941 941 941 941 941 942 
960 127 128 128 128 128 128 128 128 128 128 128 128 128 128 128 128 128 128 128 128 128 128 129 960 
960 148 149 149 149 149 149 149 149 149 149 149 149 149 149 149 149 149 149 149 149 149 149 150 960 
960 148 149 149 149 149 149 149 149 149 149 149 149 149 149 149 149 149 149 149 149 149 149 150 960 
960 148 149 149 149 149 149 149 149 149 149 149 149 149 149 149 149 149 149 149 149 149 149 150 960 
960 148 149 149 149 149 149 149 149 149 149 149 139 149 149 149 149 149 149 149 149 149 149 150 960 
960 148 149 149 149 149 149 149 149 149 149 139 139 149 149 149 149 149 149 149 149 149 149 150 960 
960 148 149 149 149 149 149 149 149 139 149 139 137 139 149 149 149 149 149 149 149 149 149 150 960 
960 148 149 149 149 149 149 149 149 149 134 135 156 136 149 149 149 149 149 149 149 149 149 150 960 
960 148 149 149 149 149 149 149 139 134 156 156 156 156 136 149 149 149 149 149 149 149 149 150 960 
960 148 149 149 149 149 139 139 149 155 156 156 156 156 157 139 149 149 149 149 149 149 149 150 960 
960 148 149 149 149 149 149 139 149 155 156 156 156 177 178 149 139 149 149 149 149 149 149 150 960 
960 148 149 149 149 149 149 149 139 176 177 177 178 149 139 139 149 149 149 149 149 149 149 150 960 
960 148 149 149 149 149 149 149 149 139 149 139 149 139 149 149 149 149 149 149 149 149 149 150 960 
960 148 149 149 149 149 149 149 149 149 149 149 149 149 149 149 149 149 149 149 149 149 149 150 960 
960 148 149 149 149 149 149 149 149 149 149 149 149 149 149 149 149 149 149 149 149 149 149 150 960 
960 148 149 149 149 149 149 149 149 149 149 149 149 149 149 149 149 149 149 149 149 149 149 150 960 
960 169 170 170 170 170 170 170 170 170 170 170 170 170 170 170 170 170 170 170 170 170 170 171 960 
980 941 941 941 941 941 941 941 941 941 941 941 941 941 941 941 941 941 941 941 941 941 941 941 982